777777777777777777777777777777777777777777777777777777777777
777777777777777777777777777777777777777777777777777777777777
777777777777777777777777777777777777777777777777777777777777
777777777777777777777777777777777777777777777777777777777777
777755555555555555555555555555555555555555555555555555557777
777753333333333333333333333333333333333333333333333333357777
777753111111111111111111111113311111111111111111111111357777
777753166666666666666666666613311111111111111111111111357777
777753162222222222222222222613344444444444444444444444357777
777753162222222222222222222613311444444444444444444411357777
777753162222222222222222222613311444444444444444444411357777
777753162222222222222222222223344444444444444444444444357777
777753166666666666666666666613311411114111111111111411357777
777753111111111111111111111113311411114111111111111411357777
777753333333333333333333333333333333333333333333333333357777
777753333333333333333333333333333333333333333333333333357777
777753111111111111111666666263311111111111111111111111357777
777753111111111111111622222263316666666661111111111111357777
777753111111111111111622222263322222222261111111111111357777
777753111111111111111622222263316222222261111111111111357777
777753111111111111111622222263316222222261111111111111357777
777753111111111111111622222263316222222261111111111111357777
777753111111111111111666666663316666666661111111111111357777
777753111111111111111111111113311111111111111111111111357777
777753333333333333333333333333333333333333333333333333357777
777755555555555555555555555552255555555555555555555555557777
777777777777777777777777777772277777777777777777777777777777
777777777777777777777777777772277777777777777777777777777777
777777777777777777777777777772277777777777777777777777777777
777777777777777777777777777772277777777777777777777777777777